
########
#      #
# .*.###
# $$$  #
#  *.. #
# $$$  #
# ...###
#  $ $ #
### **.#
#@     #
########
