 ######
##    #
#  ## ##
# #..  #
#   . @#
# $## ##
## #  #
## $ ##
#  $##
#   #
#   #
#  ##
####
