
#########
#    #  #
# $   $ #
#  $$## #
##   ## #
 ###### #
      # #
     ## ##
   ###.  #
   #...  #
   # # ###
   #   @#
   ######
