
  ###
###.#####
#@ $    #
# #*#   #
#  $  ###
###.###
 #    #
 #    #
 #  ###
 ####
