
########
#   #  #
#   #  #
##  $$ #
 # #$.###
 # #.. @#
 # ###  #
 #      #
 ########
