
    ####
    #  #
#####@ ##
#   #$. #
#    .$ #
## # $.##
 #   ###
 #####
