
     ####
  ####  #########
 ##             ##
 #      #####    #
 #   ####   ##   #
##   ########## ##
#  ####      ## #
#    ##    # ## #
#    ## # $  ## #
##   #### ##$## #
 ### ## $ ## ## #
 ### #  #$## ## #
 #..      #   $ #
 #..   #  #  $# #
 #+.  ######    #
 ######    ######
