
  #####
###   #
#   # ##
#   $  #
###$*. #
  # .###
  # @#
  ####
