
####
# @##
# .*##
# *  #
# $  #
##  ##
 ####
