
#######
#     #
#$$ $ #
# $ #.#
# #.#.#
#.#+#.#
#.#.# #
# # $ #
# $$$ #
#     #
#######
