
    ######
    #    ##
##### ##  #
#   #$$ # #
#    $@.  #
######.. ##
     #####
