
 #############
 #           #
 # ## ########
 #$#   #     #
 # $   $  #  #
 # #   # ##@ #
## ##### ### #
#  ##..#$# # #
#        ### #
###.... .##  #
  #  ##$###  #
  # ###      #
  #  # $###$ #
  ##        ##
   ##########
