
 #######
 # .   #
 # $   #
###*#@##
#  $  #
#  .###
#####
