
 #####
##   ##
#    @#
#$#####
#  ...#
# $ $ #
#...$ #
#### ##
#     #
# $$  #
##   ##
 #####
