
 #########
##   ##  #
#  #$.   #
# #@.$#  #
#   $.  ##
#########
