
#######
#  .  #
# $+$ #
#  * ##
## * ##
## *  #
# $.$ #
#  .  #
#######
