
 ####
##  #####
#  $$   #
#@$  . ##
####.#.##
 # $ .  #
 #     ##
 #######
