
   ##########
#### $.     #
#    $. #@  #
#   #$.######
##### ##
  #    #
  #    #
  #  ###
  ####
