
#######
#  #  ##
#   @  #
#.  #  #
#. .# ##
#.  # #
#.. # #
##### #
#  $  #
# $ $ #
# $$$ #
#     #
#######
