
    ####
   ##  ####
####      #
#..#   #  #
#.    ## ##
#.   ### #
######## #
  #    # #
###  $ # #
#  # #$# ##
#@        #
## #$##   #
 # $ ######
 #   #
 #####
