
 ######
##    ##
#  $   #
# $$$#@#
# $  ###
## $ #.#
#### #.#
#     .#
# #   .#
# ##$#.#
#    ..#
########
