
########
#    @ #
# $  # #
###$## #
 # . $ #
 # . # #
 ##..$ #
  ##.$ #
   ### #
     ###
