
  #######
 ##     ##
 # $ ##  #
 # #  ## #
 #  $ ## #
##  #    #
#   $   ##
#  ###$###
#   ##   #
##  ## # #
 ####  . #
    #@ ..#
    ## #.#
     #####
