
 ######
##  . #
#  .#.#
#@  . #
## ## #
 # $  #
 # $  #
 # #$ #
 # $ ##
 #    #
 ######
