
####
#  ####
#     #
# @#  #
#    ##
###$*##
 # *. #
 #    #
 ###  #
   ####
