
  ####
 ##  #
##   #
# $* #
#  * #
# #* #
#  . #
## @ #
 #####
