
  ######
  #    #
  #    #
  #  ###
####$$@#
#   $ .#
#   #..#
########
