
  #####
###   ##
#   $  ##
# $#*   #
#   *  @#
#  #*  ##
####. ##
   #.##
   ###
