
   ###########
  ##    #    #
 ##  $  # ## #
##   #       #
#    # ## ####
#  # $ #   #
## #  ##@  #
 # ####### #
 # #   # # ##
 # # $ # #  #
 # $$# ###  #
 #   $ ##.. #
 #  ## #.. .#
 #####  .  ##
     #######
