
#####
#   ###
# #.  ##
#  $   #
###*## #
#  $ # ##
#  .    #
## @#   #
 ########
