
      ####
  ##### .##
  #  . .. #
###   ..$ #
#  ###  # #
# $ ## ## #
#@  ## ## #
##$ ##$## #
 # $#  ## #
 #     ## #
 ##$## ## #
  #    ## #
  #### ## #
     #  # #
     #    #
     ######
