
#####
#   #######
# # ##    #
#     $   #
#####$*.###
    #@. #
    #####
