
#########
#   #   ####
#   @*  #  ###
####.#$#     #
  #  *     # #
  #  #####   #
  #  #   #####
  ####
