
   ####
  ##  ##
 ## $  ##
##  .*  ##
#   *.*  #
# **+*.* #
#  .*.*  #
## $    ##
 ##  $ ##
  #$$ $#
  #    #
  ##  ##
   ####
