
      ####
#######  #
# .##  $ #
# .##  # #
##.   $# #
 #.$ $ # #
 #.#  $# #
##.#$  # #
# .#  ## #
# .$ ### ##
###  ##   #
  ## #   @#
   # $   ##
   #    ##
   ######
