
   ####
   #  #
####  #
#   * #
#  . $###
####* @ #
   #    #
   ######
