
  #####
 ##   #
##  $ #
# $ # #
# # # #
# @ # #
##### #
   ## #
   #  ##
   # $ #
 ### # #
 #...  #
 #######
