
  #####
###.  #
#  *  #
# #*###
#  $ #
#  @ #
#  ###
####
