
    #####
#####   #
#  ## # #
#  @$$  #
#  #$.###
##  ..  #
  ###   #
    #####
