
   ####
####  ###
#    $  #
#   $#$ #
##   $  #
 ##  ## #
  ##### #
  ##### ##
  #.. #  #
  #+     #
  ##  .###
   #####
