
  ########
  #      ##
###       ##
#    ###   ##
#      #  $ ##
## ###.# $ $ ##
#  #  .#  $  @#
#  .  .##$ $ ##
####...## $ ##
   ### #   ##
     #    ##
     ######
