
#### ###
#@ ### #
# $$ ###
# $ .  #
## ..  #
 #######
