
################
#              #
#  ###@   ###  #
# ## ## .## ## #
# #   #.*#   # #
# #####*.##### #
#  $  $.*$  $  #
# $ $  ..  $ $ #
# #####..##### #
# #   #*.#   # #
# ## ## *## ## #
#  ### $  ###  #
#              #
################
