
########
#  .#  #
#  .#$ #
#@ .#  #
## .#  #
 # ##$ ##
 #      #
 # ##   #
 #  ##$ #
 ##$#   #
 #      #
 #     ##
 #######
