
 #########
##   #   #
#  $ $ $ #
#  #   # #
## ## $# #
#  ###   #
#  ##### #
##@#   # ##
 ### # #  #
   # .    #
   #.#.# ##
   # .   #
   #######
