
 #####
##   #
#  $ #
#@$  #
### ##
#....#
# $$ #
##   #
 #####
