
   ####
 ###..#
##  ..#
#   .+#####
# $ ###   #
#  ##   $ #
## #  ### ##
##      $  #
# $$ # ### #
#  # # # # #
#  # # ### #
######  $  #
     #  #  #
     #######
