
     ####
######  #
#   ##  #
#       #
#####$*##
#    *.#
#   #@ #
########
