
########
#      #
#  $ $ #
# $$ # #
# $  # #
#  ### #
####.# #
 #  .# #
 # $.# ##
 # . #  #
 # . @  #
 # .##  #
 ########
