
  #####
 ## @ #
 #  # #
 #$## #
 # #  #
## .$ #
#  ** #
#   *##
#  #.#
######
