
 #####
##   ##
#  $  #####
#   $   $ ##
## $ $ $   #
#  ####### #
#  ...@... #
############
