
#######    ####
#     ######  ##
# #$#  #       #
#  $       #   #
# ## ###  ###  #
# #  # #### ## #
#  $ #  ###  # #
# $#$####.#### #
#    ## ... ## ##
#######  .  @   #
      #  ## #   #
      #     #  ##
      ##########
