
    ####
  ###  #
  #    #
  #    #
 ###@###
## $$#
#  $.#
# #..#
# ## #
#    ####
##      #
 #  #   #
 ########
