
 ####
 #  #####
 #  #   #
 #  *   #
###.#$###
#   *@ #
#   #  #
#####  #
    ####
