
######
#    #
# ## #
#  $ #
#  . #
## * ##
 # *  #
 # *@ #
 # ## #
 #    #
 ######
