
 ########
 #      #
 # # #  #
## # #$ #
#  $  $ #
#  $  # #
## #$ # #
 # #  $ #
 # ##$# #
 #  #   #
##  #####
#    ####
#......+#
#########
