
    #########
 ####   ##  #
 #      $   #
 #  $##$##  #
 ##  #  .#$ #
  #$ # ..#  #
  #  $ #### ##
#### ###.    #
#   $ ##.    #
#  $  ### #$##
# $#  ##  . #
#  $ #..  . #
# $# #.  ## #
# $  #+.    #
###  ##. ####
  ########
