
  ####
 ##  ##
 #    ###
##$.#   #
#@$.    #
##$.#  ##
#  ## ##
#     #
####  #
   ####
