
       ####
########  ##
# $   $    #
#   $ $ $  #
# $###### ##
#.........+#
######### ##
#          #
#  $ $ $ $ #
#  #########
####
