
   ####
 ###  #
## .  ##
#  *   #
# #*#@ #
#  $  ##
####  #
   ####
