
        ####
 ########  #
 #      #$ #
 # $# $ #  #
 # $  $  $ #
 # #  ## # #
 #@####### ##
####  ####  #
# .#     #  #
#...  #$    #
#. . .  #####
#########
