
      ####
 ######  #
 #     $ #
## # # # #
#  $ $ # #
# $  $ # #
#   #### ##
#######.  #
  #   ..  #
  #@  .. ##
  ########
