
  ####  ####
  #  ####  ##
 ##         #
 #  ### #   #
 #      ## ##
 ###### ## #
 ####   ## #
 #+.. #  # #
 ###.    # #
   #.. ### #
########## #
#    ##    #
# $ $  $ $ #
#  $    $ ##
###  ##  ##
  ########
