
   ####
   #  #
   #  #
   #  #
####$###
#  .*.@#
#  #$###
#  #  #
##    #
 #  ###
 ####
