
     ######
   ###.#  #
   #@ *   #
######*## #
#     $   ##
#   #  #   #
########   #
       #####
