
 ####
##  #
# @ #
# $ #
# * #
# * ##
##.  #
 # # #
 #   #
 #####
