
  ####
###  #
# .$ #
# $  #
#** @#
# * ##
# #.#
#   #
#####
