
  #####
  #   #
  # # #
###   #
#  $$ #
# #$.###
# #..  #
#  #@  #
##  ## #
 ##    #
  ######
