
   ####
####  #
# $   ##
# #.   ##
# #. $  ##
# #. #$  #
# #+ #   #
# ## #  ##
#  # $ ##
##   ###
 #####
