
########
#      # #####
# **.$ # #   ##
# .*.$ # # #@ #
# $$$$ ### ## #
# .*. #    ## #
# .*. #$ #.## #
# $$$$ $ .. # #
# *.* #$ #. # #
# *..  $ #. # #
#     #$####  #
#######      ##
      ########
