
 ########
##  #   ##
#   $$#  #
#  #$@.# #
## # ..  #
#    #  ##
#   ##  #
#########
