
  ####
###  ######
#..       ##
#...# ##   #####
#..## ##  $ ## #
#. ## ## $ $ # ##
#. ##$##  $  $ @#
## ## ## $ $ # ##
 # ## ##  $ ## #
 # ## #    #####
 #        ##
 #  #### ##
 ####  ###
