
  #####
 ##   ####
 #  #  $ ##
 #   $ #  ##
## #$####  #
#  # #. ## #
#  # #.. # #
##   #.. @ #
 # $###  # #
##  ## . # #
#  $#  # # #
#        # #
####$### # #
   #       #
   #########
