
   ####
#### @#
#  $  #
# .*. #
#  $  #
## ####
#  #
#  #
#  #
####
