
  #####
  #   #
 #    #
##$*@##
# *.#
#    #
###  #
  #  #
  ####
