
#######
#   #.##
#    *@#
#####* #
  #  $ #
  #   ##
  #####
