
 #######
##  .  #
#  #*# #
#   *  #
#  #$ ##
##  @##
 #####
