
  ####
###  #
# .$ #
# .* #
##*# #
 #   #
 # $ #
 # # #
 # @ #
 #####
